5
10
0000000000
00**??**00
00******00
00*?**?*00
00******00