5
10
0000000000
000*234X00
00g?g?g?00
00X432*000
00??????00